# Code:
*-*-----
-****--*
-**-****
*-------
---*****
-*------
--------
--------
--------
--------
--------
--------
--------
--------
--------

# Data:
------*-
----****
-**-*---
-*--*---
-**--*-*
-**-**--
-**-**--
-**-****
--*-----
-***-***
-**-****
-***--*-
-**-**--
-**--*--
----*-*-
